sentence 1: Calculate time changes, create graphs showing distance versus time. [SEP] sentence 2: Line graphs are especially useful for showing changes over time.	neutral
sentence 1: For an example, refer to the densities of water-NaCl mixtures (density of water with dissolved NaCl). [SEP] sentence 2: Sugar crystals dissolving in water is an example of the formation of a mixture.	neutral
sentence 1: From the Moon to Mars, Mercury to Pluto, discover what scientists have learned about our solar system since manned space exploration began three decades ago. [SEP] sentence 2: Pluto has three moons.	neutral
sentence 1: The Earth's abundance of salt water and its generally high water content make it a good conductor. [SEP] sentence 2: The abundance of water makes the earth habitable for humans.	neutral
sentence 1: : "The planets, the sun, the stars, all belong to one species-namely that of 'stars' [bright objects moving above the earth]. [SEP] sentence 2: From earth, the sun appears brighter than any other star because the sun is the closest star	neutral
sentence 1: Female gonads are the ovaries , which produce eggs (ova) and female sex hormones. [SEP] sentence 2: The female reproductive system consists of structures that produce eggs, secrete female sex hormones, and ultimately enable birth of a fetus.	neutral
sentence 1: The result is often a stroke, heart attack, or death. [SEP] sentence 2: A heart attack or stroke is often a result of untreated atherosclerosis.	neutral
sentence 1: Since hydrogen sulfide is a gas at room temperature, ingestion is unlikely to occur. [SEP] sentence 2: Hydrogen is in gas form at room temperature.	neutral
sentence 1: Stratus,liquid, low cloud fraction( [SEP] sentence 2: Stratus clouds occur in the low of the troposphere.	neutral
sentence 1: White lines overlapped with the plasma pressure stand for the equipotential line of convection and corotation electric fields. [SEP] sentence 2: Since the electric field lines point radially away from the charge, they are perpendicular to equipotential lines.	neutral
sentence 1: If there is only one atom of a particular element, no subscript is used. [SEP] sentence 2: You call elements that contain only atoms of one type of element native elements.	neutral
sentence 1: embryo sac embedded in mamelon. [SEP] sentence 2: The amniotic sac, which was sitting on top of the flat embryo, envelops the embryo as it folds.	neutral
sentence 1: The polyanionic oligos may bind to proteins such as fibroblast growth factor and inhibit protein binding to cell surface receptors, thus inhibiting cell proliferation (29). [SEP] sentence 2: Cells secrete factor that bind to receptors.	neutral
sentence 1: Soon we will have sequenced all of the DNA in the nucleus of a human cell. [SEP] sentence 2: The cells of all protists have a nucleus.	neutral
sentence 1: Sample Preparation Peripheral blood (500 ml) or bone marrow (200 ml) was made up to 15 ml with red cell lysis buffer (154 mM ammonium chloride, 10 mM potassium bicarbonate, 0.1 mM EDTA) and left for five to 10 minutes at room temperature. [SEP] sentence 2: In the lungs, bicarbonate is transported back into the red blood cells in exchange for chloride.	neutral
sentence 1: It spreads from infected mucosal surfaces (cervix, rectum, pharynx) to the small joints of the hands, wrists, elbows, knees, and ankles but rarely to axial skeletal joints. [SEP] sentence 2: Knees and elbows are examples of the joints of the skeletal system.	neutral
sentence 1: Intrinsic factor (IF), a protein secreted by gastric parietal cells, binds to the vitamin B 12 and carries it to the terminal ileum , where there are IF receptors, and absorption occurs. [SEP] sentence 2: Cells secrete factor that bind to receptors.	entailment
sentence 1: Although surveyors are accustomed to interpreting the shape of the Earth using contour plans, the general community is more familiar with perspective views that show three-dimensional objects as they appear. [SEP] sentence 2: Contour lines show the three-dimensional shape of land.	entailment
sentence 1: So clearly, the power dissipated by an electrical component is determined by multiplying the current through the component by the voltage across the component.Â  The SI unit for power is the watt (W). [SEP] sentence 2: Power in electricity is the voltage multiplied by the current.	entailment
sentence 1: home search messages help assistant log out  AMPHIBIANS Amphibians are creatures such as frogs, toads, newts and salamanders that live both on land and in the water. [SEP] sentence 2: Frogs are amphibians that live part of the time in fresh water and live rest of the time on land.	entailment
sentence 1: Well-Connected The Ear The ear is the organ of hearing and balance and is organized into external, middle, and internal areas. [SEP] sentence 2: The ears are an external feature in human beings is responsible for balance.	entailment
sentence 1: In lakes and impoundments, and occasionally in streams, nitrogen may be the limiting nutrient and control the growth of algae and other aquatic plants, thus, using dissolved oxygen and blocking the penetration of sunlight which is needed for the growth of submerged aquatic vegetation (SAV); [SEP] sentence 2: Besides the concentration of dissolve oxygen and nutrients in the water, the availability of sunlight limits aquatic organisms.	entailment
sentence 1: Lithium is composed of three electrons bound by the electromagnetic force to a nucleus containing three protons along with either three or four neutrons, depending on the isotope, held together by the strong force. [SEP] sentence 2: Lithium has three electrons.	entailment
sentence 1: Disaccharides are formed when 2 monosaccharides molecules bond together. [SEP] sentence 2: You call the carbohydrate formed when two monosaccharides bond together disaccharide.	entailment
sentence 1: The cathode is indeed the negative electrode, where reduction occurs, and the anode the positive electrode, where oxidation takes place. [SEP] sentence 2: The electrode at which reduction occurs is called the cathode.	entailment
sentence 1: The ABC model of floral organ development proposes combinatorial interaction of A, B, and C class genes whereby these three classes of genes specifies the four floral organs, sepals, petals, stamens, and carpels. [SEP] sentence 2: Sepals, petals, stamens, and carpels are floral organs.	entailment
sentence 1: The instructions for building a cell's protein work force are contained in its chromosomes, encoded in the DNA molecule. [SEP] sentence 2: Dna encodes instructions for proteins molecules.	entailment
sentence 1: Adaptive Immune System &#0147;This helps explain why the jawed vertebrates are the only species that have a second, adaptive immune system, in addition to the innate immune system that all other species have,&#0148; Schatz, an immunologist, said. [SEP] sentence 2: Vertebrates are unique in having adaptive immunity in addition to innate immunity.	entailment
sentence 1: Our baseline knowledge of plant distributions is skeletal at best, yet plants are the primary producers in ecosystems, and all organisms ultimately depend on them. [SEP] sentence 2: All living organisms are dependent on plants because plants are producers.	entailment
sentence 1: Primary consumers are also known as heterotrophs. [SEP] sentence 2: Heterotrophs is another name for consumers.	entailment
sentence 1: Energy can neither be created nor destroyed- only converted, the energy is simply converted from one format to another. [SEP] sentence 2: Energy it can not be destroyed.	entailment
sentence 1: Plants take in carbon dioxide gas, which is made up of molecules containing one carbon atom and two oxygen atoms. [SEP] sentence 2: Carbon dioxide molecules consist of a central carbon atom bonded to two oxygen atoms.	entailment
