sentence 1: The man is aiming a gun [SEP] sentence 2: The man is drawing a gun	entailment
sentence 1: A large green ball is hitting a potato [SEP] sentence 2: A big green ball is knocking a potato	entailment
sentence 1: A large man is sitting in a military accessories shop [SEP] sentence 2: A large man is sitting in a military accessories store	entailment
sentence 1: A boy is looking at a calendar [SEP] sentence 2: A boy is staring at a calendar	entailment
sentence 1: The blonde girl with the pink top is smiling and wearing funny glasses with a large nose attached [SEP] sentence 2: A little girl is smiling and wearing a fake nose and glasses	entailment
sentence 1: Someone is stirring a pot of chili with a spoon [SEP] sentence 2: Someone is stirring chili in a pot	entailment
sentence 1: A person is chopping a red onion [SEP] sentence 2: A person is chopping an onion	entailment
sentence 1: A rainbow afghan is being held by a girl in gold and purple [SEP] sentence 2: A girl in gold and purple is holding a rainbow afghan	entailment
sentence 1: A person is slicing an onion [SEP] sentence 2: A person is cutting an onion	entailment
sentence 1: A young boy is sitting in a bathing suit and waiting for the next race [SEP] sentence 2: A young swimmer is sitting in a bathing suit and waiting for the next race	entailment
sentence 1: A motorcyclist on a bike is leaning into a sharp corner [SEP] sentence 2: A man on a motorcycle is turning around a corner	entailment
sentence 1: A group of scouts are hiking through the grass [SEP] sentence 2: Some people are walking	entailment
sentence 1: A man, a woman and two girls are walking on the beach [SEP] sentence 2: Four people are walking on the beach	entailment
sentence 1: A woman is carefully deboning a fish [SEP] sentence 2: A woman is deboning a fish	entailment
sentence 1: A man and a woman are driving down the street in a jeep [SEP] sentence 2: A man and a woman are driving down the road in a car	entailment
sentence 1: An email is being read by a man [SEP] sentence 2: A man is reading an email	entailment
sentence 1: A man is quickly chopping some mushrooms with a knife [SEP] sentence 2: A person is quickly chopping mushrooms with a knife	entailment
sentence 1: The plane is landing [SEP] sentence 2: A plane is landing	entailment
sentence 1: A man in a red uniform is swiftly making a jump in a dirt bike race [SEP] sentence 2: A man in a red uniform is making a jump in a dirt bike race	entailment
sentence 1: A boy is playing a guitar [SEP] sentence 2: A boy is playing an instrument	entailment
sentence 1: A man is leaning against a pole and is surrounded by people [SEP] sentence 2: A man is leaning against a pole and is surrounded	entailment
sentence 1: A yellow dog is running on white snow on a sunny day [SEP] sentence 2: A dog, which is tan, is running through the snow	entailment
sentence 1: A dog, which is black, and a white one are staring at each other in the street [SEP] sentence 2: A dog, which is black, and another one, which is white, are staring at each other in the street	entailment
sentence 1: Some ferrets are climbing down from a shelf [SEP] sentence 2: Ferrets are climbing down from a shelf	entailment
sentence 1: Two children are rolling in dirty water [SEP] sentence 2: Two children are rolling in muddy water	entailment
sentence 1: A group of boys is playing soccer on the seashore [SEP] sentence 2: A group of boys is playing soccer on the beach	entailment
sentence 1: A man is jumping into a pool [SEP] sentence 2: A man is diving into a pool	entailment
sentence 1: A dog is chasing a ball in the grass [SEP] sentence 2: A ball is being chased by a dog on the grass	entailment
sentence 1: A child in orange is playing outdoors with a snowball [SEP] sentence 2: A kid in orange is playing outside with a snowball	entailment
sentence 1: The man is riding a horse [SEP] sentence 2: A man is riding a horse	entailment
sentence 1: A man is skiing down a hill and over a red obstacle [SEP] sentence 2: A man is skiing down a hill and jumping a red obstacle	entailment
sentence 1: The snowboarder is jumping off the snow [SEP] sentence 2: A snowboarder is jumping off the snow	entailment
sentence 1: A man is wearing a clear plastic cap and a mask [SEP] sentence 2: A man by a brick wall is wearing a mask around his mouth and a hair net	neutral
sentence 1: A woman is boiling noodles in water [SEP] sentence 2: Someone is stirring noodles in the water	neutral
sentence 1: A dog, which is large and gray, is carrying a ball in its mouth and running across the grass [SEP] sentence 2: A large, gray ball is hitting a running dog, which is carrying some grass in its mouth	neutral
sentence 1: A man is repairing tiles with his hands [SEP] sentence 2: A man is breaking wooden boards with his hand	neutral
sentence 1: Two people are carrying colorful baskets and blankets and walking near a building [SEP] sentence 2: Two people are carrying gray baskets and blankets and walking near a building	neutral
sentence 1: A woman is not slicing carrots [SEP] sentence 2: A woman is cutting potatoes	neutral
sentence 1: Two women with dogs are walking on a forest path [SEP] sentence 2: Two dogs and two people are sitting in the woods	neutral
sentence 1: The man is stirring the sauce for the chicken [SEP] sentence 2: The man is cooking sauce for the meat	neutral
sentence 1: A person is not doing a trick on a slide [SEP] sentence 2: A snowboarder is grinding down a long concrete rail	neutral
sentence 1: A man is being roped before a climb [SEP] sentence 2: A man is climbing a rope	neutral
sentence 1: A man is pouring a plate of shredded cheese into a pot of sauce [SEP] sentence 2: A man is pouring a pot of cheese sauce into a shredded plate	neutral
sentence 1: The white dogs are looking curiously at the black llama [SEP] sentence 2: A black sheep is standing near three white dogs	neutral
sentence 1: A child, who looks young, is standing in front of some trees [SEP] sentence 2: A small boy is standing in the forest	neutral
sentence 1: A person is cutting some mushrooms [SEP] sentence 2: A person is putting away the mushrooms	neutral
sentence 1: Five kids are standing close together and none of the kids has a gun [SEP] sentence 2: Five children are standing in front of a wooden hut	neutral
sentence 1: A man in a big city is holding a sign and begging for money [SEP] sentence 2: A man in a small city is doing charity work	neutral
sentence 1: Children are playing in a fountain that is spraying water from the ground [SEP] sentence 2: Animals are playing in fountains that spray water from the ground	neutral
sentence 1: The person is not going into the water [SEP] sentence 2: The man is going into the water	neutral
sentence 1: The man is cutting the tape on the box [SEP] sentence 2: There is no man cutting a box	neutral
sentence 1: A man is shaking a drink [SEP] sentence 2: A man is mowing a lawn	neutral
sentence 1: A large white crane is flying far above the water [SEP] sentence 2: A white bird is landing swiftly in the water	neutral
sentence 1: A young occidental girl is standing above the crowd and is playing with a pinwheel [SEP] sentence 2: A girl in blue sweater is holding a multicolor toy and is sitting on the shoulders of a man with grey hair	neutral
sentence 1: A boy wearing a striped shirt is running barefoot on the sandy hill [SEP] sentence 2: A girl wearing a striped shirt is running barefoot on the sandy hill	neutral
sentence 1: A woman is cutting broccoli [SEP] sentence 2: A man is cutting tomatoes	neutral
sentence 1: The horse is being ridden by a man [SEP] sentence 2: A man is parking a motorbike	neutral
sentence 1: Four boys are kneeling next to each other in front of a ball [SEP] sentence 2: The young boys are not posing with a green soccer ball in a park	neutral
sentence 1: A dog is licking a baby [SEP] sentence 2: A baby is licking a dog	neutral
sentence 1: A large white crane is flying near the water [SEP] sentence 2: A white bird is swiftly taking off from the water	neutral
sentence 1: There is no man spraying a super soaker into the mouth of a dog [SEP] sentence 2: A person is chopping an onion	neutral
sentence 1: A man in a white hat is touching a cardboard box [SEP] sentence 2: A man in a black hat is reaching for a box	neutral
sentence 1: The kitten is eagerly drinking some milk from the bowl [SEP] sentence 2: One small child is greedily drinking water from the cup	neutral
sentence 1: A dog is being teased by a monkey at the zoo [SEP] sentence 2: A monkey is pulling a dog's tail	neutral
sentence 1: Nobody is holding a hedgehog [SEP] sentence 2: Someone is holding a hedgehog	contradiction
sentence 1: Two men are not holding fishing poles [SEP] sentence 2: Two men are holding fishing poles	contradiction
sentence 1: The woman is picking up the kangaroo [SEP] sentence 2: The kangaroo is picking up the woman	contradiction
sentence 1: A man is wearing a purple shirt and black leather chaps and is posing for the camera [SEP] sentence 2: A man is not wearing a purple shirt and black leather chaps and is posing for the camera	contradiction
sentence 1: A man is not cutting a potato [SEP] sentence 2: A man is cutting a potato	contradiction
sentence 1: A dog is jumping at a shiny blue soccer ball in a field of dry leaves [SEP] sentence 2: There is no dog jumping at a shiny blue soccer ball in a field of dry leaves	contradiction
sentence 1: The lady is peeling the potato [SEP] sentence 2: A woman is not peeling a potato	contradiction
sentence 1: A young girl in blue is jumping in the air [SEP] sentence 2: There is no girl in blue jumping in the air	contradiction
sentence 1: Two children are not playing in the surf [SEP] sentence 2: Two children are playing in the surf	contradiction
sentence 1: The little girl is not swinging and the woman is not standing behind her [SEP] sentence 2: The little girl is swinging and the woman is standing behind her	contradiction
sentence 1: A little dog is running on the sand [SEP] sentence 2: No little dog is running on the sand	contradiction
sentence 1: The boy is sitting near the blue ocean [SEP] sentence 2: The boy is wading through the blue ocean	contradiction
sentence 1: The woman is picking up a baby kangaroo [SEP] sentence 2: The woman is not picking up a baby kangaroo	contradiction
sentence 1: A lot of people are in an ice skating park [SEP] sentence 2: Not a lot of people are in an ice skating park	contradiction
sentence 1: The woman is cracking two eggs into a glass bowl [SEP] sentence 2: There is no woman cracking an egg into a bowl	contradiction
sentence 1: A dog is not running towards a ball [SEP] sentence 2: A dog is running towards a ball	contradiction
sentence 1: A person is not chopping an onion [SEP] sentence 2: A person is chopping an onion	contradiction
sentence 1: Nobody is rinsing a steak with water [SEP] sentence 2: A man is rinsing a large steak	contradiction
sentence 1: There is no monkey teasing a dog at the zoo [SEP] sentence 2: A monkey is pulling a dog's tail	contradiction
sentence 1: A black bird is taking flight from a dead tree [SEP] sentence 2: The black bird is sitting in a leafless tree	contradiction
sentence 1: The black dog is walking along a tree trunk bridge over water [SEP] sentence 2: There is no dog crossing a river on a bridge made from a fallen tree	contradiction
sentence 1: Two dogs of different breeds are looking at each other across a street [SEP] sentence 2: There are no dogs of different breeds looking at each other across a street	contradiction
sentence 1: Someone is slicing a tomato [SEP] sentence 2: Nobody is slicing a tomato	contradiction
sentence 1: A man is slicing a potato [SEP] sentence 2: There is no man slicing a potato	contradiction
sentence 1: The man is eating cereal [SEP] sentence 2: There is no man eating a bowl of cereal	contradiction
sentence 1: A man is playing the guitar [SEP] sentence 2: Nobody is playing the guitar	contradiction
sentence 1: A child in a green and white sports uniform is resting on the grass [SEP] sentence 2: A child in a green and white sports uniform is running over the grass	contradiction
sentence 1: A group of friends are riding the current in a raft [SEP] sentence 2: A group is not riding the current in a raft	contradiction
sentence 1: There is no woman frying something [SEP] sentence 2: A woman is frying something	contradiction
sentence 1: The cat perched on the table isn't looking out the window [SEP] sentence 2: The cat perched on the table is looking out the window	contradiction
sentence 1: The woman is not dicing garlic [SEP] sentence 2: The woman is dicing garlic	contradiction
sentence 1: The small child is wading through the water and is being guided by another person [SEP] sentence 2: The small child is not wading through the water and is not being guided by another person	contradiction
